https://www.youtube.com/watch?v=qyO9CXKVyaU

> CHAPTER ONE - A VISITOR FOR SHERLOCK HOLMES:
  warm - quente;
  housekeeper - empregada doméstica;
  silver tray - bandeija prateada;
  fashionable - elegante, da última moda;

> CHAPTER TWO - MISS MORSTAN'S STORY:
  rubbed - esfregou - past of to rub;
  shone - brilhou - his eyes shone -> seus olhos brilhavam - past of to shine;
  leant - inclinou - past of to lean;
  advertised - anunciou - past of to advertise;
  luggage - bagagem;
  cardboard box - caixa de papelão;
  pearl - pérola;
  handed - entregou - past of to hand;
  remark - observar;

> CHAPTER THREE - A STRANGE MEETING:
  pale - pálida;
  heaviest stick - pode ser bengala, cajado, etc;
  drawer - gaveta;
  unfolded - desdobrou;
  spread - espalhou, propagou;
  knee - joelho;
  magnifying glass - lupa;
  thin - magro;
  hooves - cascos;
  bright - brilhante;

> CHAPTER FOUR - THE DEATH OF MAJOR SHOLTO:
  astonished - surpreso, atônito;
  thick - espessa;
  bald head - careca;
  beating - batendo;
  weak - fraco;
  upset - chateado;
  greedy - ambicioso;
  grasping - ganâncioso;
  wicked - malvado; 
  dying - moribundo;
  guilt - culpa;
  rushed - apressado;

CHAPTER FIVE - THE GREAT AGRA TREASURE:
  whispered - sussurrou -> whisper - sussurrar;
  ceiling - teto;
  treasure chest - baú de tesouro;
  to lower down - abaixar, levar para baixo;

CHAPTER SIX - A TERRIBLE MURDER
  took the lamp - tocou a lâmpada, abajur, lamparina;
  bent down - curvou-se -> bend - curvar-se;
  sudden crack - rachadura repentina;
  stiff - rigido, duro
  thorn - espinho, 
  poisone - veneno;
  doorway - soleira da porta;

CHAPTER SEVEN - THE TINY FOOTPRINTS
  footprints - pegadas;
  window-sill - peitoril da janela;
  beneath - abaixo;
  set of steps - conjunto de passos, etapas;
  rope - corda;
  thick dust - poeira espessa;
  bare feet - descalço;
  dwarf - anão;
  pygmy - pigmeu;

CHAPTER EIGHT - INSPECTOR JONES MAKES AN ARREST
  arrest - prender, prender um bandido;
  revenge - vingança;
  chemistry - quimica;
  He loud cry of joy - ele deu um grito de alegria;
  tar - alcatrão;
  creosote - creosote mesmo;
  





