https://www.youtube.com/watch?v=1Iv-Ttr_Xm8

A STANGER

> CHAPTER ONE - A STRANGER IN THE WOODEND
  Woodend - uma cidade na Austrália;
  what a pit > é uma pena;
  coat - casaco;
  glad - alegre, contente;

> CHAPTER TWO - THE VILLAGE MEETING
  nonsense - absurso, disparate, tolice;
  shouting - gritaram;
  clapped - aplaudiram;
  cheap - barato;
  profit - lucro;

> CHAPTER THREE - THE CORNER SHOP
  wage - salário, remuneração;
  pleased - satisfeito;
  stockroom - almoxarifado, estoque;

> CHAPTER FOUR - A BEAUTIFUL CUSTOMER
  hurry - apressado; 
  frightened - assustado; 
  pale - padilo;

> CHAPTER FIVE - A PAGE IN 'FILM NEWS'

> CHAPTER SIX - A QUICK KISS
  daytime - um dia;

> CHAPTER SEVEN - ANOTHER SPECIAL ORDER
  fiance - noivo;
  loudly - som alto;

> CHAPTER EIGHT - THE FOOTBOL BATCH
  goalkeeper - goleiro;
  injured - machucado;

> CHAPTER NINE - THE SECRET WEEKEND
  bored - entediado;

> CHAPTER THEN - A QUARREL
  quarrel - briga, discussão;
  autumn - outono;

> CHAPTER ELEVEN - ARTHUR RISEMAN
  middle-aged - meia idade;
  briefcase - pasta, maleta;
  liar - mentiroso;
  wrists - pulsos;
  hurriefly - apressado;

> CHAPTER TWELVE - ANNA WAITS FOR NEWS
  advertisement - propaganda, anúncio;
  annoyed - incomodado, aborrecido;

> CHAPTER THIRTEEN - THE SPECIAL ORDERS ROOM
  underneath - por baixo, em baixo de alguma coisa;

> CHAPTER FOURTEEN - THE SPECIAL CUSTOMERS

> CHAPTER FIFTEEN - 31ST OCTOBER
  