https://www.youtube.com/watch?v=-5Ey8LoqoLg

> CHAPTER ONE - THE SAILING SHIP:
  sailing ship - veleiro, navio a velas;
  buckskin dress - vestido de couro ou pele de animal;
  moccasins - sapato de couro ou pele de animal;
  feather - pena;
  longhouse - maloca, casa indigena grande onde moram muitas famílias;
  canoes - canoa;
  paddle - remo;
  paddled up/down the river - remou rio acima/abaixo;
  obey - obedecer;
  sticks - gravetos, pau;

> CHAPTER TWO - POCAHONTAS MEETS JOHN SMITH:
  settlement - acentamento;
  huts - cabanas;
  storehouse - armazém;
  church - igreja;
  angry - bravo, furioso;
  crops - safras (to plant crops - plantar para colher);
  to hunt - caçar;
  to fish - pescar;
  be lazy - preguiçoso;
  compass - bússola;
  needle - agulha;
  beads - miçangas;
  trinkets - bugigangas;

> CHAPTER THREE - WINTER IN JAMESTOWN:
  ill - doente;
  weak - fraco;
  brought - trouxe;
  cabin - cabana, feita de madeira;
  gunpowder - polvora;

> CHAPTER FOUR - CHIEF POWHATAN DECLARES WAR:
  sunset - por do sol;
  tricket - enganou;
  copper kettle - chaleira de cobre;
  colored beads - miçangas coloridas;
  they were kind - eles foram gentis;

> CHAPTER FIVE - POCAHONTAS FALLS IN LOVE:
  embraced - abraçou;
  wedding meal - jantar do casamento;
  she wore - ela vestiu;
  mourned - expressar tristesa por alguém que morreu;
  heartbroken - coração partido, extretamente triste;
  grow tobacco - cultivar tabaco;
  remained - permaneceu;

