https://www.youtube.com/watch?v=WHKSc6vmJ0o&t=1s

ROBINSON CRUSOÉ

> CHAPTER ONE - MY FIRST SEA JORNEY
  sailor - marinheiro;
  sailed - navegou;
  rough - duro, rude, aspero;
  dropped - caiu - the wind dropped -> o vendo diminuiu;
  thieves - ladrões;
  thief - ladrão;

> CHAPTER TWO - DOWN THE COAST OF AFRICA:
  shore - costa, praia, margem;
  shoot - atirar;
  seabirds - aves marinhas;

> CHAPTER THREE - THE STORM AND THE SHIPWRECK:
  shipwreck - naufrágio;
  wrecked - naufragado;

> CHAPTER FOUR - A NEW LINE ON AN ISLAND:
  ropes - corda;
  sail - vela de veleiro;
  tent - tenda, barraca;
  fence - cerca;

> CHAPTER FIVE - LEARNING TO LIVE ALONE:
  I went on - eu continuei;
  dried - secou -> dry - seca;

> CHAPTER SIX - A FOOTPRINT:
  hurried - apressado;
  goats - cabra;
  somehow - de alguma forma;

> CHAPTER SEVEN - MAN FRIDAY:
  hurriedly - apressadamente
  trousers - calças;
  coat - casaco;
  tent - barraca;

> CHAPTER EIGHT - ESCAPE FROM THE ISLAND:
  tied - amarrado;
  rope - corda;
  mutiny - motim;

> CHAPTER NINE - HOME IN ENGLAND:
  nephews - sobrinhos;
  
