https://www.youtube.com/watch?v=EqbN9BfZetY

> CHAPTER ONE - SCHOOL AND FOOTBOLL
  ship - navio
  ordinary school - escola para pessoas com necessidades especiais;
  laugh - sorrir (lóóf)
  heavier - mais pesado;
  taught - ensinou (touth)
  prettiest - mais bonita;
  got down lower - desceu mais...
  it came open - abriu;
  screamed - gritou de susto;

> CHAPTER TWO -  LIFE AT UNIVERSITY
  he meant - 
  practice field - 
  harmonica - 
  when it got late - quando entardeceu;

> CHAPTER THREE - THE BIG GAME
  army - forças armadas, exercíto;

> CHAPTER FOUR - VIETNAM
  shouted - gritou
  shouted lounder - gritaram mais alto;
  cupboard - guarda-louça;
  tins - lata;
  boiler - caldeira;
  heats - aquecer;
  hurry up - se apresse;
  hungry - faminto;
  angry - furioso;
  blew up - 

> CHAPTER FIVE - DANGER IN THE JUNGLE
  valley - vale;
  hill - colina;
  planes - aviões;
  thick  - grosso, espesso, 
  machine gun - metralhadora;
  shouting as loundly as I could - gritando tão alto quanto eu podia;
  halfway - nome meio do caminho;
  hurt - machucado, ferido;
  worst - pior;
  fire-throwers - atiando foro;

> CHAPTER SIX - THE WHITE HOUSE:
  ape - gorila, macaco;
  waiter - garçonete;
  trousers - calça;

> CHAPTER SEVEN - MEETING JENNY AGAIN:
  untidy - desarrumado;
  loud - barulhento;
  eyes shut - olhos fechados;

> CHAPTER EIGHT - INTO SPACE:
  spring - primavera;
  summer - verão;
  crowds - multidão;
  theirs - deles (algo que pertence a eles);

> CHAPTER NINE - A REAL IDIOT:
  temperer - ???
  wrestling - luta;
  arm-wrestled - braço de ferro;
  bet - apostar;
  plenty of people - muita gente;
  worse - pior;

> CHAPTER TEN - MONEY FOR PLAYING GAMES:
  waved/wave hand - acenar;

> CHAPTER ELEVEN - THE SHRIMP BUSINESS:
  bought - comprar;
  start up - começar;
  net - rede
  go shrimping - pescar camarão;
  autumn - outono;
  chinking of - 
  time went on - o tempo passou;

> CHAPTER TWELVE - LITTLE FORREST:
  went on - passou;
