THE LAST OF MOHICANS

https://youtu.be/upuQtJM-tH0

CHAPTER ONE - THE TWO SISTERS
  beat - bater;

CHAPTER TWO - LOST IN THE FOREST
  scaut - olheiro, batedor;
  rode out - sair de um logar;
  to paddle - remar;

CHAPTER THREE - THE FIGHT AT GLEN'S FALL
  shouts - gritos;
  cries - choros;
  rushing - 

CHAPTER FOUR - I AM A HURAN CHIEF
  brandy - conhaque;

CHAPTER FIVE - FORT WILLIAM HENRY
  stabbed - facada;
  thick - grosso, espesso;
  fog - névoa, neblina;

CHAPTER SIX - WHEN WILL HELP COME

CHAPTER SEVEN - THE TRAIL
  burnt down - queimado, incendiado;
  body lay on the ground - corpo deitado sobre o solo;

CHAPTER EIGHT - THE MEDICINE MAN
  Where shall we go? - Onde nós iremos?
  tied with rope - amarrado com uma corda;
  untied - desamarrou;

CHAPTER TEN - THE BEAR
  cloth - pano, tecido;
  blanket - cobertor;

CHAPTER ELEVEN - THE OLD CHIEF  
  meeting-house - casa de reunião;
  weak - fraco;

CHAPTER TWELVE - THE LAST OF THE MOHICANS
  heard shouts - ouviu gritos;
  stabbed - facada;
  graves - cova;

