
https://www.youtube.com/watch?v=sC6l5aAxLM8&t=1365s

> 10/05/21
felt - sentiu
narrow path - caminho estreito
harder - mais difícil
rough ground - terreno acidentado
whispered - sussurrou
boat - bote, barco
rubber tube - tubo de borracha
saw - serra
sick - doente
sighed - suspirou, bufou
supper time - hora do jantar
grabbed - agarrou
nodded - confirmou com a cabeça
blade - lâmina
frightened - assustado
blanket - cobertor
lorry - caminhão
wheelchair - cadeira de rodas
---------------------------------------------------
> 11/05/21
Chapter Seven:
  throat - garganta;
  staring - encarando;
  well-known - bem conhecido;
  keep them away - mantenha-os longe;
  lit a something - acendeu alguma coisa;
  luckily - felizmente, por sorte;
  purse - bolsa, carteira;
  crowd of others - multidão de pessoas;
  crowded office - escritório abarrotado;
  glad - alegre, feliz;
  pleasantly - prazerosamente, agradavelmente;
  ma'am - senhora;
  sorts - ordenar, classificar;
  thoughtfully - pensativamente;
Chapter Eight:
  saw - viu;
  frightened - assustado, amedrontado;
  stood close by - permaneceu perto; 
  said - disse;
  proudly - orgulhosamente;
  tied - amarrado, atado;
  waist - cintura;
  what for? - Pelo que? Para que?
  clever kid - criança inteligente;
  hurry - pressa;
  take you down - leva-lo, derruba-lo; 
  from now on - de agora em diante;
Chapter Nine:
  was pleased - satisfeito
  amused - divertida
  coming out - 
  so far - até agora
---------------------------------------------------
> 12/05/21
Chapter Ten:
  he was on his way - ele estava a caminho;
  early - cedo;
  worry - preocupado;
  mood - humor, disposição;
  shouted angrily - gritou com raiva;
  banging the door - bateu forte a porta;
Chaper Eleven:
  cold - frio;
  knee - joelho;
  young guest - jovem convidado; 
  fresh - fresco;
  spoiled - estragado, mimado;
Chapter Twelve: - 1:13:45



