AROUND THE WORLD IN EIGHTY DAYS - JULES VERNES

https://youtu.be/eoqBgaxBo94

> CHAPTER ONE - WHEN PHILEAS FOGG MEETS PASSEPARTOUR
  passepartour - moldura de quadro;
  charity - caridade;
  manservant - criado, mordomo;
  loyal - leal, fiel
  armchair - poltrona;
  rode - past of ride -> montar. Ex: montar na bike, montar no cavalo;
  firm stare - olhar firme, encarando;
  upset - chateado;
  worried - preocupado;
  untidy - dassarumado;
  curly - encaracolado -> curly hair;

> CHAPTER TWO - WHEN PHILEAS FOGG MAKES A BET
  bet - aposta;
  robbery - roubo;
  thief - ladrão;
  stole - roubou -> past of steal;
  cashier - encarregaod do caixa;
  shipwreck - naufrágio;

> CHAPTER THREE - WHEN GENTLEMEN ARE THIEVES
  thieves -> thief - ladrões;
  reward - recompensa;
  whispered - sussurrou;
  warrant - um mandato, uma garantia;
  arrest - prender, deter;
  bet - aposta;
  rickshaw - riquixá, taxi indiano pequeno para duas pessoas;
  cows - vacas;

> CHAPTER FOUR - WHEN OUR ADVENTURERS RESCUE A WOMAN FROM CERTAIN DEATH
  rescue - resgatar;
  sunrise - alvorada, nascer do sol;
  crowd - povo;
  bonfire - fogueira;

> CHAPTER FIVE - WHEN PASSEPARTOUT BECOMES AN ACROBAT
  penny - centavo;
  bald head - careca;
  drums - bateria;

> CHAPTER SIX - WHEN OUR FRIENDS RISK THEIS LIVES
  railway - estrada de ferro, trilhos do trem;
  deep ravines - ravinas profundas;
  whistles - assobio, apito;

> CHAPTER SEVEN - WHEN PHILEAS FOGG COMES TO THE RESCUE
  42:20
