ALICE IN THE WONDERLAND

Chapter One - Down the rabbit-hole
  hurried on - correu, apressado;
  either - senão (usado em frases negativas)
  cupboards - armário, guarda-louças;
  whiskers - bigode de gato ou rato;
  what's the use of crying? - o que adianta chorar?

Chapter Two - The pool of tears
  curiouser - curioso;
  nonsense - sem sentido, estúpido;
  ceiling - teto;
  she lay - ela deitou;
  fan - ventilador;
  worse - pior;
  swam - nadou (past of swim);
  way out - como sair;
  kindly - gentil;
  duchess - duquesa;

Chapter Three - Conversation with a caterpillar
  caterpillar - lagarta;
  little bigger - pouco maior;
  felt a little cross - sentiu um pouco zangada, contrariada;
  smoke the pipe - 
  aloud - em voz alta;
  thief - ladrão;
  go away - vá embora;

Chapter Four - The Cheshire Cat
  plate - prato
  grinning - sorrindo;
  mistake - erro, engano;
  I'm pleased - estou satisfeito;
  mad - louco;
  croquet - criquet;
  vanished - vaish - desaparecer de repende;

Chapter Five - A mad tea-party
  desk - mesa de escritório, escrivaninha, balcão;
  sadly - tristemente;
  poured - derramou (um liquido em algum lugar);
  hare - lebre;

Chapter Six - The Queen's game of croquet
  gardeners - jardineiros;
  lay down flat on her face - deitou-se plano????
  crowd - multidão;
  knaves - valete (baralho);
  hedgehogs - porco-espinho;
  mallets - taco de criquet;
  hoops - aros, argolas;
  grin - sorisso largo;
  argue - argumentar, discordar;
  gryphon - grifo (animal mitológico)

Chapter Seven - Who stole the tarts?
  tarts - tortilhas;
  trumped - trompete;
  trial - julgamento (contexto de corte)
  witness - testemunha;
  blew - soprou;
  hatter - chapeleiro;
  mile high - milhas de altura;
  hurry on - se apressar;
  sixpence - seis pence - moeda britânica;
  flew up - voou para cima;





  Radio Clovis
  Tuit
  



  




